call log	гісторыя выклікаў
call	выклікаць	выклік	выклікаць
speaker	галосьнік
forward	перасылаць
calls	выклікі
forwarding	перасыланьне	перасылаць
conference	нарада
conference call	выклік да нарады
options	можнасьці
status bar	паліца стану
notifications	спавяшчэньні
statusbar	паліца стану
desktop	стольніца
invalid	хібны
unlock	адмыкаць
PIN code	код PIN
SIM card	картка SIM
vCard	візытоўка
composer	укладальнік
haptic	дотыкавы
sensor	чуйнік
IM	паведамляльнік
server	паслужнік
automatically	самарушна
import	браць
export	вымаць
again	зноўку
authenticating	апазнаваньне	Authenticating
